11332211132322112231
10122222222221113311
10000000110000000001
12113310000111011102
132100110111R1000101
1N111011000132110101
12221013310113010100
11300000110211010111
21101010000000010121
0000101R011012220001
11011000011000111011
12010033013210111001
100101200112301B1111
13110211222221111222
1122111G113211333311