RRRRRRRRRRRRRRRRRRRR
10122222222221113311
10000000110000000001
121133B0000111011102
132100GGGGGGGGGG1013
RRRRRRRRRRRRRRRRRRRR
122GG10R331011301010
11300G00110211010111
2110G0R0000000010121
00000000000000000000
1101G000011000111011
1201G033013210111001
1001G1200112301B1111
13110G11222221111222
RRRRRRRRRRRRRRRRRRRR